11111111111111
1C0010000000C1
10E0C011111001
1P00111E000001
11111111111111
